100
8
22 22  22 22 22 22 22 22 22 22 22 22 22 22 22 22 22 22 22 22 22 22 22 22 22 22 22 22 22 22 22 22 22 22 22 22 22 22 22 22 22 22 22 22 22 22 22 22 22 22 22 22 22 22 22 22 22 22 22 22 22 22 22 22 22 22 22 22 22 22 22 22 22 22 22 22 22 22 22 22 22 22 22 22 22 22 22 22 22 22 22 22 22 22 22 22 22 22 22 22 22 22 22
22 22  22 22 22 22 22 22 22 17 17 17 17 17 17 22 0  17 17 22 22 22 22 17 17 17 17 17 17 22 22 22 22 22 22 22 22 0  0  0  22 22 22 0  22 22 22 17 17 17 17 17 17 17 22 22 22 22 22 22 22 19 18 22 22 22 22 22 22 22 22 22 0  22 22 22 22 22 22 22 22 22 22 17 17 17 22 22 22 17 17 22 22 22 17 22 22 22 22 17 17 17 19
22 22  22 22 22 22 22 22 19 0  0  0  0  0  0  0  0  0  0  22 22 17 17 0  0  0  0  0  0  0  0  22 22 0  0  0  22 0  0  0  22 22 22 0  0  22 0  0  0  0  0  0  0  0  17 17 17 17 22 22 22 4  0  17 22 22 22 0  0  0  0  0  0  0  17 17 17 22 22 22 17 17 17 0  0  0  17 17 17 0  3  22 22 19 0  17 17 17 17  0  0  0  0
22 22  19 17 17 17 17 17 0  0  0  0  0  0  0  0  0  0  0  0  0  0  0  0  0  0  0  0  0  0  0  0  0  0  0  0  0  0  0  0  0  0  0  0  0  0  0  11 0  0  0  0  0  0  0  0  9  0  17 17 17 0  0  0  17 17 17 0  0  0  0  0  0  0  0  0  0  17 17 17 0  0  0  0  0  0  0  0  0  0  0  3  22 4  0  0  0  0  0  0  0  11 0
22 4   0  0  0  0  0  0  0  0  0  0  3  22 4  0  0  0  0  0  0  0  0  0  0  0  0  0  0  0  0  3  22 4  0  0  0  0  0  0  0  0  0  0  0  0  0  21 21 21 0  0  0  11 1  21 21 21 2  0  0  0  0  0  0  0  0  0  0  1  21 21 21 2  0  0  0  0  0  0  0  0  0  0  0  0  0  0  0  0  0  3  22 4  0  0  0  0  9  11 21 21 9
22 4   0  0  0  0  3  22 4  0  0  3  22 22 22 4  0  0  0  0  0  0  0  0  0  0  0  0  0  0  3  22 22 22 4  0  0  0  22 0  0  0  0  9  9  0  0  22 22 22 4  0  1  21 2  0  0  0  1  21 2  0  0  0  0  0  9  1  21 2  0  0  0  0  0  3  22 4  0  0  0  3  22 4  0  0  0  0  0  0  0  0  17  0  0  0  0  10 21 21 22 22 22
22 22  22 0  0  3  22 22 4  0  3  22 22 22 22 22 4  3  22 0  0  0  0  0  0  0  0  22 4  0  3  22 22 22 22 22 22 22 22 0  0  0  0  22 22 22 22 22 22 22 4  0  9  0  0  0  0  0  0  0  0  22 22 22 22 22 22 0  0  0  0  11 0  0  3  22 22 4  0  0  11 22 22 22 0  0  3  22 22 22 22 4  3  22 22 4  1  21 22 22 22 22 22
22 22  22 22 22 22 22 22 22 22 22 22 22 22 22 22 22 22 22 0  0  3  22 22 4  0  0  22 22 22 22 22 22 22 22 22 22 22 22 0  22 22 22 22 22 22 22 22 22 22 22 22 22 22 0  0  0  0  0  0  22 22 22 22 22 22 22 22 22 22 22 22 22 22 22 22 22 22 22 22 22 22 22 22 22 22 22 22 22 22 22 22 22 22 22 22 22 22 22 22 22 22 22